  #### 
###  ##
#  *  #
#  *  #
#  * ##
## * # 
 # * # 
 # * # 
 # * # 
 # * # 
 # *@# 
 # *$# 
 # . # 
 ##### 