 ####         
##  ##########
#         @$ #
# **********.#
##           #
 #   #########
 #####        