   ####
  ##  #
### $ #
#  @$ #
# $#$ #
#  .. #
#  ..##
###### 