    #### 
##### @# 
#   $$ # 
# $... # 
##$..*$##
 # ...$ #
 # $$   #
 #  #####
 ####    