  ####
###  #
#  $ ##
# #.. #
#@ .# #
##$ $ #
 #  ###
 ####