####    
#@ #### 
# $$  ##
# $ #  #
# #  # #
# ...  #
#   ####
#####   