 ##### 
 #   ##
 # .. #
## #. #
# $$$##
#@   # 
##  ## 
 ####  