#####
#.  #
#$  #
#.$@#
#$  #
#.  #
#####