######
#... #
#$$@ #
#  $ #
#  ###
####  