   #####
   #   #
####$# #
#  *.# #
#  *@# #
#  **# #
#  # # #
#      #
########