##############
#            #
# * * * * *  #
#           ##
# * # # # # # 
#           # 
# * * * * * # 
#           # 
# # # # # * # 
#           # 
# +$* * * * # 
#           # 
############# 