 #####   
 #   ##  
##.   #  
# ..  #  
# . . #  
# ..# #  
# .   #  
#  # ####
# # $   #
#  $@$  #
# $$$$$ #
#      ##
######## 