        ####  
    #####  #  
    #   #  #  
    #  .$. ###
##### # #   .#
# @ # # #### #
# *   #     .#
## ## $.$ $$ #
## ######## ##
# $$ $.$ ## ##
#.     #   * #
# #### # #   #
#.   # # #####
### .$.  #    
  #  #   #    
  #  #####    
  ####        