 #####  
 #@  ###
##$#   #
#  .$# #
# #**  #
#  . # #
###    #
  ######