#######
#    ##
# $ $##
#@ #. #
# $$ .#
##  ..#
#######