########
##  #..#
#   $  #
# .#$  #
# $   ##
### @###
########