#########
#      ##
# #$##$##
#  $.. ##
#@#.    #
### #$$ #
###   # #
#####.#.#
#########