#######
##    #
##$#$@#
## $  #
#. $ ##
#... ##
#######