########
### @###
# $   ##
# $$# ##
#   $* #
###    #
###....#
########