#########
###  ####
# $  ####
# ##  ###
# +*  ###
##. $$###
## *  ###
####  .##
#########