######
# @  #
#.#  #
# $$.#
# # .#
#  $ #
###  #
######