########
##   ###
##     #
## ##  #
#@ #  ##
# $ $$##
## ...##
########