#######
##   ##
##*$  #
#  *#@#
#   # #
##  . #
#######