 ##### 
 #@  ##
##$# .#
# $  .#
# #$# #
# .   #
#######