#########
#########
#########
##    ###
## #.$ ##
# $ $.$##
# #$ *.@#
#  . . ##
#########