########
###  ###
# $  ###
#  # ###
# *#@###
##   $ #
## ..  #
########