 ####### 
 #     # 
 # $ $ # 
 #@$ $ # 
##### ###
#. .    #
#       #
#. .#####
#####    