  #####
###   #
# $.. #
# #**##
#     #
##$#  #
 #   @#
 ######