 #####  
 #   ## 
 # *  ##
 ## #  #
### #  #
#@$$$$ #
# ....##
###  ## 
  #  #  
  ####  