#####    
#@  ###  
# # $ #  
#     #  
####*####
#  ...  #
# #$    #
#   #$###
###   #  
  #####  