 #####  
 # @ ###
 # $   #
###$## #
#   # .#
#   $$.#
#   # .#
##### .#
    ####