   #####  
   #   #  
####   ###
#  $$$$$@#
# #..... #
# #***** #
#        #
##########