########
#   ####
#      #
## ##  #
#@ #  ##
# $$$ ##
## ...##
########