 #### 
 #  ##
## $@#
#..$$#
#**$.#
#..  #
## $ #
 #  ##
 #### 