 #####
 #   #
##$# #
#  . #
#@#$.#
#  . #
##$# #
 #   #
 #####