####   
#. #   
#.$####
#  @  #
# ### #
#   $ #
#  ####
#  #   
####   