######
#    #
# #. #
#@$  #
### ##
# $  #
# #  #
#  . #
######